#_#####
#____##
#_##_##
#_##__#
#_##_##
