#####_#
#_____#
#_#####
#___#_#
#_#_###
